1	1	1	1	1	0	1	1	1	1	1
1	6	2	6	2	0	6	2	1	1	1
2	3	1	0	1	1	1	6	0	1	1
0	4	0	2	1	0	0	4	2	0	1
2	1	0	0	1	1	0	2	0	1	1
1	0	6	6	1	0	2	1	2	5	2
2	4	0	1	2	0	2	1	2	2	2
0	6	2	5	1	6	4	2	1	0	1
6	6	1	2	2	1	2	1	2	6	6
2	1	2	2	1	2	0	2	2	0	2
2	2	2	4	2	1	1	0	2	1	6
2	1	2	2	6	2	1	2	1	6	2
1	2	2	1	2	0	1	0	2	1	1
2	2	1	1	1	2	1	2	4	2	0
2	2	0	2	2	1	2	3	2	3	2
2	1	2	6	2	1	1	2	1	2	0
2	2	1	1	2	2	2	1	2	0	2
1	2	2	1	1	2	2	2	1	0	0
2	2	2	1	2	2	1	0	0	1	6
1	1	3	1	0	0	0	0	1	0	0
2	2	4	6	1	4	4	4	0	1	6
1	1	1	1	7	7	7	7	1	1	1